--------------------
--------------------
-----------11111----
---111111111---11---
---1------1-----1---
---1--1-b-p-1---1---
---1-11--1----1-1---
---1-11-s1111-1-1---
---1--------1-1-1---
---1-11--11---1-1---
---1-11-s----11-1---
---1-----11-----1---
---11111111111111---
--------------------
--------------------
