00000000000000000000
00000000000000000000
00000000000111110000
00011111111100011000
00010000001000001000
00010010000010001000
00010110010000101000
00010110011110101000
00010000000010101000
00010110011000101000
00010110000001101000
00010000011000001000
00011111111111111000
00000000000000000000
00000000000000000000
